0 0 0 0 0 0 0 0 0 0 0 0 0 0 0 0
0 2 1 0 0 0 0 0 0 0 0 0 0 0 0 0
0 0 1 0 0 0 0 0 0 0 0 0 0 0 0 0
0 0 1 0 0 0 0 0 0 0 0 0 0 0 0 0
0 0 1 0 0 0 0 0 0 0 0 0 0 0 0 0
0 0 1 0 0 0 0 0 0 0 0 0 3 0 0 0
0 0 1 1 1 1 0 0 0 1 1 1 1 0 0 0
0 0 0 0 0 1 0 0 0 1 0 0 0 0 0 0
0 0 0 0 0 1 1 1 1 1 0 0 0 0 0 0
0 0 0 0 0 0 0 0 0 0 0 0 0 0 0 0
0 0 0 0 0 0 0 0 0 0 0 0 0 0 0 0
0 0 0 0 0 0 0 0 0 0 0 0 0 0 0 0
20
5500
14
N1
N1
N1
N1
N1
N1
N1
N1 30 N1
N1 30 N1
N1 30 N1
R1 60 N1
S1 30 S1 30 S1 30 S1 90 S1 120 S1
F1 30 F1 30 F1 30 F1 90 F1 120 F1
I1 30 I1 30 I1 30 I1 90 I1 120 I1